R 640 480

NO ./textures/brick.xpm
SO ./textures/stone.xpm
WE ./textures/cave.xpm
EA ./textures/wood.xpm

S ./textures/guard.xpm

F 0,0,0
C 255,255,255

11111111  111111
10000001  100001
10011001  100001
10001001  111111
100N0001
11111111